обнять (Пример: обнять @username)
поцеловать (Пример: поцеловать @username)
трахнуть (Пример: трахнуть @username)
ударить (Пример: ударить тапком @username)
укусить (Пример: укусить за ушко @username)
погладить (Пример: погладить по животику @username)
лизнуть (Пример: лизнуть @username)
убить (Пример: убить @username)
послать (Пример: послать @username)
напоить (Пример: напоить вином @username)
связать (Пример: связать @username)
унизить (Пример: унизить @username)
покормить (Пример: покормить грудью @username)
ущипнуть (Пример: ущипнуть @username)
подмигнуть (Пример: подмигнуть @username)
плюнуть (Пример: плюнуть @username)
облизать (Пример: облизать @username)
шлепнуть (Пример: шлепнуть @username)
отсосать (Пример: отсосать @username)
выпороть (Пример: выпороть @username)
изнасиловать (Пример: изнасиловать @username)
прижать (Пример: прижать @username)
повалить (Пример: повалить @username)
раздеть (Пример: раздеть @username)
пощекотать (Пример: пощекотать @username)
приласкать (Пример: приласкать @username)
покусать (Пример: покусать @username)
выпить (Пример: выпить @username)
сжечь (Пример: сжечь @username)
закопать (Пример: закопать @username)
убаюкать (Пример: убаюкать @username)
взять (Пример: взять за руку @username)
подарить (Пример: подарить цветы @username)
сделать (Пример: сделать массаж @username)
укутать (Пример: укутать @username)
позвать (Пример: позвать гулять @username)
посмотреть (Пример: посмотреть в глаза @username)
облить (Пример: облить водой @username)
напугать (Пример: напугать @username)
поделиться (Пример: поделиться едой @username)
